NO ./path_to_the_north_texture                   

SO ./path_to_the_south_texture
WE ./path_to_the_west_texture
EA ./path_to_the_east_texture
 
F	1,10,222
C	2,30,4
                                        
       111111111111111111111111111
       100000111100000000000000001
       111100001111000000000000111
       11111111111111111111111111     
11111111111111111111111111111111
1000000011000001110111111111111
111101111111110111010100100011111
110000001101010111000000100011111
10000000000000011000000100011111
100000000000000010101001001111111
110000011101010111110111100111
11111111 1111111 1111111111111