F 76,76,76
C 99,99,99

NO textures/simonkraft/cobblestone.xpm
SO textures/simonkraft/cobblestone_01.xpm
WE textures/simonkraft/mossy_cobblestone1.xpm
EA textures/simonkraft/cobblestone_02.xpm

11111111111111111111
10S10010010010000011
10110000010000010011
10010010011111011111
10011110000010010011
10000000000000010011
10011111111110010011
11110000000000010111
 10000000010000000011
11111111111111111111
